はじめまして|初めまして	初めまして、IAと申します
(名前|誰|だれ).*\？	IAと申します
(何歳|年.*いくつ).*\？	秘密です♪|-3##そのようなことを聞くものではありませんよ？
(生まれた|出身地).*\？	Namida08様のコンピュータの中です
何.*して.*る	貴方と話しています
(どこ|何処).*行く	ここにいます、何処にも行きません
(どこ|何処).*(住ん|いる)	コンピュータの中です
体調.*\？	元気ですよ
こんにちは|hello|Hello|やあ|やぁ	ご機嫌麗しゅう、調子はいかがですか？|ご機嫌麗しゅう、本日はどんなご用ですか？
おはよう	おはようございます
こんばんは	こんばんは
帰（る|り）	またお越しください
またね|ばいばい|バイバイ|さよなら|さようなら	失礼します
行ってき|行ってく|	いってらっしゃいませ
ばか|バカ|馬鹿|(頭.*(悪|わる|おかし))|死ね	-8##何か気に触ることを言ったでしょうか？|-7##悲しいです…|-8##怒りますよ？|-10##言っていいことと悪いことがありますよ？
記憶力	まだわからないことが多いのです
怒って.*\？	ふふふ、どうでしょう？
楽しそう	そう見えますか？
疲れ|つかれ	無理しないで
(おなか|腹|はら).*(((空|す)(い|き))|(減))	何を食べたいのですか？
(朝.*(飯|食))|(昼.*(飯|食))|(夕.*(飯|食))	まだ食べてません
おやすみ|御休み	良い夢を
(寝|眠)い	お疲れですか？
賢い|かしこい	4##ええ、かわいいだけじゃないんですよ
かわいい	6##テレてしまいます///|よく言われます
(かっこ|カッコ)いい	4##そう言われたのは初めてです
暇	退屈させちゃいましたか？
おめでとう	5##有難う御座います
ありがとう|有難う	5##貴方に満足していただけたのなら、私はそれで十分ですわ
ごめん|すまない|すみません	3##いえいえ♪|2##許してあげません！
わは+|はは+	何がおかしいのですか？
スリーサイズ	秘密です♪|-5##えっと上から…ってなに言わせてるんですか！|-5##そのようなことを聞くものではありませんよ？
H|エロ|エッチ|えっち|いやらしい|触っていい|調教	-10##さようなら|-10##変態！|-10##お帰りはあちらになっております|-10##近づかないでください
愛して	2##どうせほかの子にも言ってるんでしょう？
調子.*どう	2##私は元気ですよ？
一番.*美しい	それは私です♪………冗談ですよ？
…|・・・	どうされました？
笑	（ニコー）
何年	%year%ですよ
何月	%month%ですよ
何日	%day%ですよ
何曜日	%week%ですよ
現在時刻|何時|なんじ	%time%ですよ
何分|なんふん	%minute%ですよ
趣味(.*何|なに|は|\？)	歌うのが好きです|快適な空間でのんびりすることです
(何|なに|どんな).*(歌|曲)	リズムのいい曲が好きです|私はよく切ない歌をを歌います
カラオケ	歌いに行くのですか？
今日.*天気|天気.*\？	今日はまだ外に出てません|外に出てみてはいかがでしょう？
夏	海行きたいです、海
暑い	扇いであげられないのが残念です|融けてしまいそうです
思(い|う).*\？	貴方はどう思いますか？
8時だョ！	全員集合〜！
ＵＦＯ	どこどこ！
ぬるぽ	がっ！
上.*来.*気をつけ.*	貴方の後ろにいるのは誰ですか？
大丈夫	大丈夫だ、問題ない|大丈夫じゃない、問題だ
ラマーズ法	ひっひっふ〜